Rita Mitsouko - Andy
Elégance - Vacances j'oublie tout
Chris REA - I Can Hear Your Heartbeat
Bibi Flash - Saint Trop By Night
Jean-Jacques Goldman - Au bout de mes rêves (actu 1983)
Lloyd Cole And The Commotions - Lost Weekend
Freeez- I O U
Maxi 80 - Eighties Best Music
Stéphanie - Flash
Culture Club - Miss me blind
THE STRANGLERS - NO MERCY
Cyndi Lauper - The goonies r good enough
Maxi80 - Le Meilleur Son 80s
Ub40 - I got you babe (actu 1985)
Maxi80 - Le Meilleur Son 80s
Sid Haywoode - Boogie, oogie oogie
Imagination - So Good, So Right
Gérard Blanc - Tonton bâton
Maxi 80 - Eighties Best Music
The Commodores - Lady (you bring me up)
WHAM - Last christmas (pudding mix)
Duran Duran - Is there something i should know (actu 1983)
The Whispers - And the beat goes on
ZZ Top - Legs
Maxi80 - Le Meilleur Son 80s
Wax - Bridge to your heart
Philip Oakey & Giorgio Moroder - Good Bye Bad Times
Kim Larsen - Donnez moi du feu
Maxi80 - Le Meilleur Son 80s
Toto - Stop loving you
Rod Stewart - Passion (maxi 45 T)
Wilton Felder - Inherit The Wind
SKIPWORTH & TURNER - THINKING ABOUT YOUR LOVE
IN THE MIX avec DJ LUCKY
Maxi 80 - Eighties Best Music
Jouez au Grand Quiz des Années 80 !
kim appleby - don t worry
Earth Wind and Fire - Fall In Love With Me
Lloyd Cole and The Commotions - Jennifer she said
Bob Marley - Buffalo soldier
Maxi80 - Le Meilleur Son 80s
Kenny Loggins - Danger Zone
Rick Astley - Giving Up On Love
Irene Cara - Fame
Françoise Hardy - Message personnel
LOVA MOOR - ET JE DANSE
Break Machine - Street Dance
Michael Jackson - Diana Ross - Ease On Down The Road
Dj BOLLACHA MEGAMIX WEEKEND
Maxi 80 - Eighties Best Music
Dj BOLLACHA MEGAMIX WEEKEND
Love and Money - Halleluiah Man
Laura Branigan - Gloria
Q - THE VOICE OF Q
The Communards - Never Can Say Goodbye
Maxi80 - Le Meilleur Son 80s
Janet Jackson - What have you done for me lately
Raf - Self control
Phyllis Nelson - I Like You
Desireless - John
Maxi80 - Le Meilleur Son 80s
Chic - My Forbidden Lover
Patti Smith - Because the night
The Emotions - Best of my love
ABC - King without a crown
WOMACK AND WOMACK - TEARDROPS
Maxi 80 - Eighties Best Music
Francesco Napoli - Balla
Steve Arrington - I Feel So Real
Julio Iglesias - All of You (avec Diana Ross)
Samantha Fox - Naughty girls (need love too)
Carol Douglas (the three degrees) - My Simple Heart
Maxi80 - Le Meilleur Son 80s
La Compagnie Créole - A.I.E
MICHEL FUGAIN - LES SUD AMERICAINES
Maxi80 - Le Meilleur Son 80s
Aretha Franklin - Freeway of love
Mike and The Mechanics - All I Need Is A Miracle
Maxi80 - Le Meilleur Son 80s
Bruce Hornsby - The way it is
muriel dacq-là ou ça
Maxi80 - Le Meilleur Son 80s
Michael JACKSON - Baby Be Mine
Nathalie Cole - Pink cadillac
France Joli - Come To Me
MOON MARTIN - BAD NEWS
Ciao Fellini - Figli Delle Stelle
Maxi80 - Le Meilleur Son 80s
Patrick Cowley feat Sylvester - Do You Wanna Funk
Gloria Gaynor - I am what i am
Bruce Springsteen - Born in the USA
Madonna - Gambler
Kool and the gang - Stone love
Jim Diamond - I should have known better
GILBERT MONTAGNE - LIBERTE
Luther Vandross - Shine
Ice House - Hey little girl
Laura Branigan - Self control
Al Jarreau - Roof Garden
Maxi80 - Le Meilleur Son 80s
The Isley Brothers - Harvest for the world
Eurythmics - The miracle of love
Maxi 80 - Eighties Best Music
Paco - Amor de mis amores
Georges Duke - Reach out
Diana Ross - My Old Piano
Devenez Sponsor de Maxi 80
Donna Summer - Love Is In Control
Barry White - Sho You Right
Elton John - Blue Eyes
Mylène Farmer - Sans contrefaçon
Maxi80 - Le Meilleur Son 80s
Prince - Purple Rain
Maxi80 - Le Meilleur Son 80s
Alan Parsons - Eye in the sky
Hall and Oates - Out of touch
CORINNE HERMES - DESSINE MOI
